10
10
- - H - Z Z H - - Z
Z H - - H - - H - -
H H - Z - H - - Z -
- Z - - Z - - - - -
- - - - - - H - - H
- - Z - - H - Z - -
H - - - H - - - - -
- - Z Z - - - - - -
- - - Z - - - - H -
H H - - - - Z - - -